%%%%%%%%%%%%%%%%%%%%%%
%%  %%  %%  %%  %%  %%
%%%%%%%%%%%%%%%%%%%%%%
%%  %%  %%  %%  %%  %%
%%%%%%%%%%%%%%%%%%%%%%
%%  %%  %%  %%  %%  %%
%%%%%%%%%%%%%%%%%%%%%%
%%  %%  %%  %%  %%  %%
%%%%%%%%%%%%%%%%%%%%%%
%%  %%  %%  %%  %%  %%
%%%%%%%%%%%%%%%%%%%%%%

%%%%%%%%%%%%%%%%%%%%%%
%%                  %%
%%  %%  %%  %%  %%  %%
%%                  %%
%%  %%  %%  %%  %%  %%
%%                  %%
%%  %%  %%  %%  %%  %%
%%                  %%
%%  %%  %%  %%  %%  %%
%%                  %%
%%%%%%%%%%%%%%%%%%%%%%
