%%%%%%%%%%
%%      %%
%%  %%  %%
%%  %%  %%
%%%%%%%%%%
