%%%%%%%%%%%%%%%%%%%%%%
%%      %%          %%
%%  %%%%%%%%%%%%%%  %%
%%      %%      %%  %%
%%  %%  %%  %%  %%  %%
%%  %%  %%  %%  %%  %%
%%  %%  %%  %%  %%  %%
%%  %%  %%  %%  %%  %%
%%  %%  %%  %%  %%  %%
%%  %%      %%      %%
%%%%%%%%%%%%%%%%%%%%%%
