%%%%%%%%%%%%%%%%%%%%%%
%%      %%          %%
%%%%%%  %%%%%%%%%%  %%
%%  %%      %%      %%
%%  %%%%%%  %%  %%%%%%
%%          %%      %%
%%%%%%  %%%%%%%%%%  %%
%%      %%      %%  %%
%%  %%%%%%  %%  %%  %%
%%          %%      %%
%%%%%%%%%%%%%%%%%%%%%%
